----:
 *----  a;
 -*---  o;
 --*--  e;
 ---*-  u;
 ----*  i;
 **---  w;
 -**--  l;
 --**-  j;
 ---**  y;
 *--*   n;
 ***--  .;
 -***-  ,;
 --***  ';
U*----  p;
U-*---  t;
U--*--  c;
U---*-  k;
U----*  q;
U**---  b;
U-**--  d;
U--**-  r;
U---**  g;
U*--*-  m;
U***--  :;
U-***-  ;;
L*----  f;
L-*---  s;
L--*--  sh;
L---*-  x;
L----*  h;
L**---  v;
L-**--  z;
L--**-  gh;
L*--*-  ng;
L***--  ";
L-***-  (;
L--***  );
*---= S+----
